안대 : Blindfold
바디슈트 : Bodysuit
고무 슈트 : Gimp suit
본디지 의상 : Bondage outfit
라텍스 : Latex
모노글러브 : Monoglove
본디지 의상 : Bondage outfit
사슬 : Chain
젖꼭지 체인 : Nipple chain
정조 벨트 : Chastity belt
정조 브라 : Chastity bra
정조 장치 : Chastity cage
클램프 : Clamp
클리토리스 클램프 : Clitoris clamp
젖꼭지 클램프 : Nipple clamps
혀 클램프 : Tongue clamp
목걸이 : Collar
수갑 : Cuffs
족쇄 : Shackles
손쇠고랑 : Handcuffs
호블 : Hobble
재갈 : Gag
볼 재갈 : Ball gag
빗 재갈 : Bit gag
C형 재갈 : Cleave gag
팬티 재갈 : Panty gag
플러그 재갈 : Plug gag
고리 재갈 : Ring gag
테이프 재갈 : Tape gag
고무 슈트 : Gimp suit
가죽끈 : Leash
클리토리스 가죽끈 : Clitoris leash
음경 가죽끈 : Leash on penis
젖꼭지 가죽끈 : Nipple leash
코걸이 : Nose hook
피어싱 : Piercing
피어싱들 : Piercings
머리채 : Pillory
구속대 : Stocks
밧줄 : Rope
샅바 줄 : Crotch rope
사운딩 : Sounding
스프레더바 : Spreader bar
채찍 : Whip
말채찍 : Riding crop
목마 의자 : Wooden horse
유다의 요람 : Judas cradle
