새해 : New Year's Day
춘절 : Chinese New Year
발렌타인데이 : Valentine's Day
성 패트릭의 날 : Saint Patrick's Day
부활절 : Easter
하나미 : Hanami
메이드의 날 : Maid Day
미국 독립기념일 : Fourth of July
오본 : Obon
여름 축제 : Summer Festival
팬티의 날 : Panties day
옥토버페스트 : Oktoberfest
할로윈 : Halloween
추수감사절 : Thanksgiving
크리스마스 : Christmas
기념일 : Anniversary
생일 : Birthday
생일 축하해 : Happy Birthday
축하해 : Congratulations
이정표 기념 : Milestone celebration
고마워 : Thank You
아케오메 : Akeome
새해 복 많이 받으세요 : Happy New Year
가도마쓰 : Kadomatsu
카가미모치 : Kagami Mochi
고토요로 : Kotoyoro
모치츠키 : Mochitsuki
연하장 : Nengajou
오토시다마 : Otoshidama
시메카자리 : Shimekazari
홍바오 : Hongbao
폭죽 : Firecrackers
불꽃놀이 : Fireworks
다오 푸 : Dao Fu
년(신화) : Nian (mythology)
사자춤 : Lion Dance
용춤 : Dragon Dance
마키즈시 : Makizushi
마메마키 : Mamemaki
마스 : Masu
초콜릿 상자 : Box of Chocolates
하트 모양 초콜릿 : Heart-shaped chocolate
해피 발렌타인 : Happy Valentine
하트 모양 상자 : Heart-shaped box
발렌타인 : Valentine
종이 등 : Paper lantern
공중 폭죽 : Aerial Fireworks
음식 부스 : Food stands
사격 갤러리 : Shooting gallery
금붕어 뜨기 : Goldfish scooping
물고기 봉지 : bagged fish
해피 할로윈 : Happy Halloween
잭오랜턴 : Jack-o'-lantern
과자 내놔 : Trick or treat
크리스마스트리 : Christmas Tree
메리 크리스마스 : Merry Christmas
겨우살이 : Mistletoe
산타클로스 : Santa Claus
산타 복장 : Santa Costume
