정액 : cum
부카케 : bukkake
정액 덤프 : cumdump
정액 목욕 : cum bath
정액 방울 : cumdrip
정액 풀 : cum pool
정액 팽창 : cum inflation
항문에 사정 : cum in ass
옷에 사정 : cum in clothes
컵에 사정 : cum in cup
입에 사정 : cum in mouth
목구멍에 사정 : cum in throat
혀에 사정 : cum on tongue
질에 사정 : cum in pussy
요도에 사정 : cum in urethra
몸에 사정 : cum on body
머리에 사정 : cum on hair
엉덩이에 사정 : cum on ass
질에 사정 : cum on pussy
가슴에 사정 : cum on breasts
손가락에 사정 : cum on fingers
옷에 사정 : cum on clothes
안경에 사정 : cum on glasses
음식에 사정 : cum on food
사정 : ejaculation
삽입 중 사정 : ejaculating while penetrated
사정 후 빼기 : pull out
얼굴 사정 : facial
자위 얼굴 사정 : autofacial
펠칭 : felching
고쿤 : gokkun
