로리 : loli
성숙한 여성 : mature female
목줄 당기기 : leash pull
펫 플레이 : pet play
인간 개 : human dog
포니 플레이 : pony play
거인 : giant
거대 여성 : giantess
미니걸 : minigirl
근육질 : muscular
근육질 여성 : muscular female
통통한 : plump
곡선미 있는 : curvy
마른 : skinny
가슴 확대 : breast expansion
거대한 가슴 : gigantic breasts
여러 가슴으로 숨막히게 하기 : multiple breast smother
수유 : lactation
모유 수유 : breastfeeding
옷을 통해 수유 : lactation through clothes
BDSM : bdsm
질식 : asphyxiation
목 조르기 : strangling
속박 : bondage
가슴 속박 : breast bondage
고문 속박 : predicament bondage
시바리 : shibari
스프레더 바 : spreader bar
서스펜션 : suspension
여성 지배 : femdom
여성 주도 : female domination
옷 입은 여성, 나체 남성 : clothed female nude male
단호한 여성 : assertive female
얼굴에 앉기 : facesitting
얼굴에 앉기 : sitting on face
굴욕 : humiliation
몸에 글쓰기 : body writing
방치 플레이 : neglect play
공공 사용 : public use
계산 : tally
로프 걷기 : rope walking
노예 : slave
엉덩이 맞기 : spanked
고문 : torture
클리토리스 고문 : clitoris torture
유두 고문 : nipple torture
유두 당기기 : nipple pull
고환 때리기 : ball busting
간지럼 고문 : tickle torture
왁스 플레이 : wax play
근친상간 : incest
쌍둥이 근친상간 : twincest
강간 : rape
여성 주도 강간 : femdom rape
임박한 강간 : imminent rape
성추행 : molestation
치한 : chikan
보상 성추행 : compensated molestation
숨막히게 하기 : smother
가슴으로 숨막히게 하기 : breast smother
여성 사정 : female ejaculation
음부 액체 : pussy juice
인간 가구 : human furniture
인간 화장실 : human toilet
포니필리아 : forniphilia
메카와 소녀 : mecha on girl
임신 : pregnant
임신시키기 : impregnation
자기애 : selfcest
촉수 : tentacles
합의된 촉수 : consensual tentacles
촉수로 입 막기 : tentacle gagged
촉수로 자위 : tentaclejob
촉수 섹스 : tentacle sex
허벅지 사이에 촉수 : tentacles in thighhighs
옷 아래 촉수 : tentacles under clothes
남성에게 촉수 : tentacles on male
너무 많은 촉수 : too many tentacles
관장 : enema
소변 : peeing
소변 마시기 : drinking pee
황금 샤워 : golden shower
시청자에게 소변 보기 : peeing on viewer
자기 소변 보기 : peeing self
