발로 하는 자위 : footjob
이중 발로 하는 자위 : double footjob
암시된 발로 하는 자위 : implied footjob
협력 발로 하는 자위 : cooperative footjob
신발로 하는 자위 : shoejob
발 : feet
발 핥기 : licking foot
발 숭배 : foot worship
발 냄새 맡기 : smelling feet
마찰 : frottage
겨드랑이 섹스 : armpit sex
비비기 : grinding
등으로 하는 자위 : backjob
엉덩이로 하는 자위 : buttjob
이중 비비기 : double grinding
무릎 뒤로 하는 섹스 : kneepit sex
파이즈리 : paizuri
가슴 근육으로 하는 자위 : Pecjob
협력 파이즈리 : cooperative paizuri
나이즈리 : naizuri
옷 위로 파이즈리 : paizuri over clothes
무릎 위 파이즈리 : paizuri on lap
옷 속 파이즈리 : paizuri under clothes
허벅지 섹스 : thigh sex
더듬기 : groping
엉덩이 잡기 : ass grab
가슴 잡기 : breast grab
유도된 가슴 잡기 : guided breast grab
가슴 근육 잡기 : pectoral grab
유도된 가슴 근육 잡기 : guided pectoral grab
젖꼭지 비틀기 : nipple tweak
사타구니 잡기 : crotch grab
유도된 사타구니 잡기 : guided crotch grab
자신의 가슴 잡기 : grabbing own breast
몸통 잡기 : torso grab
머리카락으로 하는 자위 : hairjob
손으로 하는 자위 : handjob
고환 애무 : caressing testicles
이중 손으로 하는 자위 : double handjob
협력 손으로 하는 자위 : cooperative handjob
간호 손으로 하는 자위 : nursing handjob
뒤에서 손으로 하는 자위 : reach-around
두 손으로 하는 자위 : two-handed handjob
자위 : masturbation
옷 입고 자위 : clothed masturbation
사타구니 문지르기 : crotch rub
건물 섹스 : building sex
베개 섹스 : pillow sex
테디 베어 섹스 : teddy bear sex
테이블 섹스 : table sex
암시된 자위 : implied masturbation
남성 자위 : male masturbation
상호 자위 : mutual masturbation
은밀한 자위 : stealth masturbation
꼬리 자위 : tail masturbation
꼬리 : tail
꼬리 삽입 : tail insertion
꼬리 자위 : tail masturbation
꼬리로 하는 자위 : tailjob
구강 성교 : oral
항문 애무 : anilingus
트롬본 : trombone
가슴 빨기 : breast sucking
커닐링구스 : cunnilingus
자기 커닐링구스 : autocunnilingus
암시된 커닐링구스 : implied cunnilingus
펠라티오 : fellatio
자기 펠라티오 : autofellatio
정액 교환 : cum swap
딥스로트 : deepthroat
암시된 펠라티오 : implied fellatio
이루마티오 : irrumatio
협력 펠라티오 : cooperative fellatio
다수의 남근 펠라티오 : multiple penis fellatio
얼굴에 앉기 : sitting on face
고환 빨기 : testicle sucking
고환 핥기 : licking testicle
단체 성교 : group sex
양성애 : bisexual
양성애 여성 : bisexual female
양성애 남성 : bisexual male
데이지 체인 : daisy chain
갱뱅 : gangbang
이중 삽입 : double penetration
삼중 삽입 : triple penetration
러브 트레인 : love train
협력 펠라티오 : cooperative fellatio
협력 발자위 : cooperative footjob
다수의 가슴 압박 : multiple breast smother
오르지 : orgy
역 스핏로스트 : reverse spitroast
스핏로스트 : spitroast
팀워크 : teamwork
쓰리썸 : threesome
물건 삽입 : object insertion
질 물건 삽입 : vaginal object insertion
항문 물건 삽입 : anal object insertion
대형 삽입 : large insertion
복부 팽창 : stomach bulge
음식 삽입 : food insertion
동물 삽입 : animal insertion
다중 삽입 : multiple insertions
요도 삽입 : urethral insertion
사운딩 : sounding
자궁경부 관통 : cervical penetration
유두 관통 : nipple penetration
코잡 : nosejob
손가락질 : fingering
항문 손가락질 : anal fingering
전립선 착유 : prostate milking
옷 위로 손가락질 : fingering through clothes
팬티 위로 손가락질 : fingering through panties
암시된 손가락질 : implied fingering
주먹질 : fisting
항문 주먹질 : anal fisting
자기 주먹질 : self fisting
성교 : sex
성교 후 : after sex
항문 후 : after anal
엉덩이 자위 후 : after buttjob
펠라티오 후 : after fellatio
손가락질 후 : after fingering
마찰 후 : after frottage
삽입 후 : after insertion
자위 후 : after masturbation
구강 성교 후 : after oral
가슴 자위 후 : after paizuri
강간 후 : after rape
요도 후 : after urethral
질 후 : after vaginal
여운 : afterglow
옷 입은 채 성교 후 : clothed after sex
항문 성교 : anal
이중 항문 성교 : double anal
임박한 항문 성교 : imminent anal
페깅 : pegging
삼중 항문 성교 : triple anal
옷 입은 채 성교 : clothed sex
유도된 삽입 : guided penetration
행복한 성교 : happy sex
임박한 삽입 : imminent penetration
암시된 성교 : implied sex
배꼽 성교 : navel sex
뒤에서 하는 성교 : sex from behind
두개골 성교 : skull fucking
귀 성교 : ear sex
눈에 남근 삽입 : penis in eye
촉수 성교 : tentacle sex
수중 성교 : underwater sex
질 성교 : vaginal
질 성교 후 : after vaginal
이중 질 성교 : double vaginal
임박한 질 성교 : imminent vaginal
삼중 질 성교 : triple vaginal
백합 : yuri
암시된 백합 : implied yuri
트리바디즘 : tribadism
