항문 구슬 : anal beads
항문 꼬리 : anal tail
인공 질 : artificial vagina
텐가 : tenga
항문 플러그 : butt plug
아네로스 : aneros
꼬리 플러그 : butt plug tail
음경 링 : cock ring
딜도 : dildo
더블 딜도 : double dildo
거대 딜도 : huge dildo
드래곤 딜도 : dragon dildo
말 딜도 : horse dildo
가시 딜도 : spiked dildo
스트랩온 : strap-on
흡착 컵 딜도 : suction cup dildo
딜도 타기 : dildo riding
음식 삽입 : food insertion
딜도 개그 : dildo gag
마스크 챌린지 (밈) : mask challenge (meme)
딜도 하네스 : dildo harness
팬티 속 딜도 : dildo under panties
전립선 마사지기 : prostate massager
펌프 : pump
유방 펌프 : breast pump
클리토리스 펌프 : clitoris pump
섹스 머신 : sex machine
너무 많은 섹스 토이 : too many sex toys
사운딩 : sounding
카테터 : catheter
요도 구슬 : urethral beads
바이브레이터 : vibrator
토끼 바이브레이터 : bunny vibrator
나비 바이브레이터 : butterfly vibrator
알 바이브레이터 : egg vibrator
히타치 매직 완드 : hitachi magic wand
리모컨 바이브레이터 : remote control vibrator
라이딩 머신 : riding machine
시비안 : sybian
공공 바이브레이터 : public vibrator
옷 속 바이브레이터 : vibrator under clothes
레그 가터 속 바이브레이터 : vibrator in leg garter
니삭스 속 바이브레이터 : vibrator in thighhighs
허벅지 스트랩 속 바이브레이터 : vibrator in thigh strap
팬티 속 바이브레이터 : vibrator under panties
팬티호스 속 바이브레이터 : vibrator under pantyhose
유두 위 바이브레이터 : vibrator on nipple
항문 속 바이브레이터 : vibrator in anus
음경 위 바이브레이터 : vibrator on penis
