란제리 : Lingerie
베이비돌 : Babydoll
바디스타킹 : Bodystocking
브라 : Bra
버스티에 : Bustier
캐미솔 : Camisole
쉬미즈 : Chemise
코르셋 : Corset
그물 스타킹 : Fishnets
가터 스트랩 : Garter straps
가터 벨트 : Garter belt
레이스 : Lace
나이트가운 : Nightgown
팬티 : Panties
보이쇼츠 팬티 : Boyshort panties
스트랩 없는 하의 : Strapless bottom
테디 : Teddy
허벅지 스타킹 : Thighhighs
끈 팬티 : Thong
G-스트링 : G-string
진주 끈 팬티 : Pearl thong
남성 속옷 : Male Underwear
트렁크 팬티 : Boxers
브리프 : Briefs
복서 브리프 : Boxer briefs
비키니 브리프 : Bikini briefs
볼 브라 : Ball bra
엉덩이 노출 : ass cutout
하의 없음 : bottomless
부르마 당김 : buruma pull
부르마 비낌 : buruma aside
클리토리스 슬립 : clitoris slip
옷 비낌 : clothing aside
가랑이 컷아웃 : crotch cutout
드레스 비낌 : dress aside
레오타드 비낌 : leotard aside
하카마 당김 : hakama pull
기모노 들기 : kimono lift
유카타 들기 : yukata lift
팬티 없음 : no panties
팬티 비낌 : panties aside
바지 당김 : pants pull
오픈 바지 : open pants
팬티 들기 : panty lift
팬티 당김 : panty pull
음부 엿보기 : pussy peek
팬티호스 당김 : pantyhose pull
반바지 비낌 : shorts aside
오픈 반바지 : open shorts
반바지 당김 : shorts pull
치마 한쪽 다리에 : skirt around one leg
치마 발목에 : skirt around ankles
오픈 치마 : open skirt
치마 당김 : skirt pull
치마 들기 : skirt lift
수영복 비낌 : swimsuit aside
비키니 비낌 : bikini aside
