발찌 : anklet
팔 벨트 : arm belt
완장 : armband
팔찌 : armlet
팔찌 : bracelet
뱅글 : bangle
스파이크 팔찌 : spiked bracelet
신부용 건틀릿 : bridal gauntlets
분리형 소매 : detached sleeves
팔 워머 : arm warmers
복싱 글러브 : boxing gloves
팔꿈치 장갑 : elbow gloves
손가락 없는 장갑 : fingerless gloves
신부용 건틀릿 : bridal gauntlets
스파이크 장갑 : spiked gloves
유가케 : yugake
벙어리 장갑 : mittens
허벅지띠 : thighlet
넓은 소매 : wide sleeves
손목 밴드 : wristband
손목 커프스 : wrist cuffs
손목 스크런치 : wrist scrunchie
반지 : ring
클로우 링 : claw ring
결혼 반지 : wedding ring
겨드랑이 : armpits
겨드랑이 노출 : armpit cutout
맨팔 : bare arms
팔 노출 : arm cutout
맨어깨 : bare shoulders
오프숄더 : off shoulder
어깨 노출 : shoulder cutout
소매 걷어올림 : sleeves rolled up
민소매 : sleeveless
낮은 암홀 : low-cut armhole
소매 밀어올림 : sleeves pushed up
소매 걷어올림 : sleeves rolled up
