단발머리 : bowl cut
스포츠머리 : buzz cut
촌마게 : chonmage
크루컷 : crew cut
플랫탑 : flattop
오카파 : okappa
픽시컷 : pixie cut
언더컷 : undercut
보브컷 : bob cut
뒤집힌 머리 : flipped hair
콘로우 : cornrows
드레드락 : dreadlocks
히메컷 : hime cut
멀릿 : mullet
리본 모양 머리 : bow-shaped hair
땋은 머리 : braid
앞머리 땋기 : braided bangs
앞쪽 땋기 : front braid
옆 땋기 : side braid
프렌치 브레이드 : french braid
크라운 브레이드 : crown braid
단일 땋기 : single braid
다중 땋기 : multiple braids
쌍 땋기 : twin braids
낮은 쌍 땋기 : low twin braids
세 갈래 땋기 : tri braids
네 갈래 땋기 : quad braids
헤어 번 : hair bun
땋은 번 : braided bun
단일 헤어 번 : single hair bun
이중 번 : double bun
콘 헤어 번 : cone hair bun
도넛 헤어 번 : doughnut hair bun
하트 헤어 번 : heart hair bun
삼중 번 : triple bun
헤어 링 : hair rings
반 업두 : half updo
한쪽 업 : one side up
양쪽 업 : two side up
낮게 땋은 긴 머리 : low-braided long hair
낮게 묶은 긴 머리 : low-tied long hair
미즈라 : mizura
다중 묶기 : multi-tied hair
니혼가미 : nihongami
포니테일 : ponytail
접힌 포니테일 : folded ponytail
앞쪽 포니테일 : front ponytail
높은 포니테일 : high ponytail
짧은 포니테일 : short ponytail
옆 포니테일 : side ponytail
분리된 포니테일 : split ponytail
상투 : topknot
트윈테일 : twintails
낮은 트윈테일 : low twintails
짧은 트윈테일 : short twintails
불균형 트윈테일 : uneven twintails
세 갈래 테일 : tri tails
네 갈래 테일 : quad tails
다섯 갈래 테일 : quin tails
아프로 : afro
거대한 아프로 : huge afro
벌집 머리 : beehive hairdo
폼파두르 : pompadour
퀴프 : quiff
쇼텐 페가수스 믹스 모리 : shouten pegasus mix mori
